1111111111111
1001000000C1
1000011111001
1P0011E0001
1111111111111
